XXXXXXXXXXXXXXXXXXXXXXXXXXXXXXXXDDDDDDX
XXXXXXXXXXXXXXXXXXXXXXXGGXXXXDXXDDDDDDX
XXSXXXXXXXXXXXXXDDDXXXXDGGDXXXSXDDDDDDX
XXXXXDDXXXXXXXXXDDDXXXXBGGGGXXXXXXDDDDX
XXXXXXDXXXXXXGGXDDDXXXBDGGDWXXXXXBXDDDX
XXXXXXBDDXXXXGGXXXXXXXXXDXXWWDXXGGGGGDX
XXXXXXXXXXXSXXDXXXXWWXXXXXXSXXXGXGXGGDX
XXXXXXXDDDBXXXBDXXXXWXXXXXDGGXXXDDXXDDX
XXXXXXXXBDDXXXDXXXXXXXXXXXDBXXXXWWWWWDX
XXXXXXXXGWWXXXXXXXDDDXXXXXXGGXXXXDBDXXX
XXXXXXXXWWWXGGGXXXDGGXXXXXXGGXXXXDDDXXX
XXXXGGDDDXXGGGGBXXDXXXXXXXXGGXXXGGGWWXX
XDXXDDDXXGGGGGGXXXDGXXWWWXXWWWXXXXBDXXX
XXXWGGDXXDXGGGGDDDDGXXXGGGGXXXDXDXDDXXX
XXSXGGXXBXXGGXXDXXXDDXWWGGGWWWXSDDGBXXX
XXXWGGDXXDXXXXXDXXXXXXWWWWWWWWXXGGDWXXX
XXXWGGXXXXXBXXXXXXXXXXXXXDDGGGGXWWGGXXX
XXXXGGDXXXDDDXXXXXXGGXXXXXXGGGGXDDGXDDX
XXXDDXXXXDDDDXXXXXXGGXXXXXXGBGGXDDGXDDX
XXXGDDDXXXXXXXXXXXDDDXXXXXXGGGGXXXXXDDX
XXXXXXDXXXXXXXXXXXDBXXXXXXXXDXXDGGGBDDX
XXXDXXDXXXXBDDXXXXXXXXXXXXXDXXSXXXXGDDX
XXSXXXDDXXXDXXXXXXXXXXXXXXXXXXXXXXXXXXX
XXXXXXXXXXXXXXXXSXXXXXXXXXXXXXXXXXXXXXX
XXXXXXXXXXXXXXXXXXXXXXXXXXXXXXXXXXXXXXX